type octile
height 49
width 49
map
.................................................
.................................................
.................................................
.................................................
.................................................
.................................................
.................................................
........................TT.......................
.......................TTT.......................
.......................TTT.......................
.................................................
.................................................
.................................................
.................................................
.................................................
...............TTTT............TTTT..............
...............TTTT............TTTT..............
...............TTTT............TTTT..............
...............TTT.............TTT...............
.................................................
.................................................
.................................................
.................................................
.................................................
.................................................
.................................................
.................................................
.................................................
.................................................
.................................................
.................................................
...............TTTT............TTTT..............
...............TTTT............TTTT..............
...............TTTT............TTTT..............
...............TTT.............TTT...............
.................................................
.................................................
.................................................
.................................................
.................................................
.................................................
.................................................
.................................................
.................................................
.................................................
.................................................
.................................................
.................................................
.................................................
